0,0,0,0,1,2,2,0,2,2,2,2,2,2,0,0,0,0,0,0,0,1,3,3,3,4,4,4,4,4,4,5,5,5,5,5,4,0,0,0
0,0,0,0,1,2,2,0,2,2,2,2,2,2,0,0,0,0,0,0,0,1,3,3,3,4,4,4,4,4,4,5,5,5,5,5,4,0,0,0
0,2,2,2,1,5,2,2,2,5,5,5,5,2,0,0,0,3,3,3,3,1,5,5,5,5,5,5,5,5,5,5,5,5,5,5,4,0,0,0
0,3,5,5,1,5,5,5,1,5,5,5,5,3,0,3,3,3,5,5,5,1,5,5,5,5,5,5,5,5,5,5,5,5,5,2,2,0,0,0
0,3,5,5,1,1,1,5,1,5,5,5,5,3,0,3,5,5,5,5,5,1,5,5,5,5,5,5,5,5,5,5,5,5,5,2,0,0,0,0
0,3,5,5,1,5,5,5,1,5,5,5,5,3,0,3,5,5,5,5,5,5,5,5,5,5,5,5,5,5,5,5,5,5,2,2,0,0,0,0
0,3,5,5,1,5,5,5,1,5,5,5,5,3,3,3,5,5,5,5,5,5,5,5,5,5,5,5,5,5,5,5,5,5,5,2,0,0,0,0
0,3,5,5,1,1,1,1,1,5,5,5,5,5,5,5,5,5,5,5,5,5,5,5,5,5,5,5,5,5,5,5,5,5,5,2,0,0,0,0
0,3,5,5,5,5,5,5,5,5,5,5,5,5,5,5,5,5,5,5,5,5,5,5,5,5,5,5,5,5,5,2,2,2,2,2,0,0,0,0
3,3,5,5,5,5,5,5,5,5,5,5,5,5,5,5,5,5,5,5,5,5,5,5,5,5,5,5,5,5,5,2,0,0,0,0,0,0,0,0
1,5,5,5,5,5,5,5,5,5,5,5,5,5,5,5,5,5,5,5,5,5,5,5,5,5,5,5,5,5,5,2,2,2,2,2,0,0,0,0
1,5,5,5,5,5,5,5,5,5,5,5,5,5,5,5,5,5,1,1,1,1,5,5,5,5,5,5,5,5,5,5,5,6,2,2,0,0,0,0
1,5,5,5,5,5,5,5,5,5,5,5,5,5,5,5,5,5,1,5,5,1,5,5,5,5,5,5,5,5,5,5,5,6,2,2,2,0,0,0
1,5,5,5,5,5,5,5,5,5,5,5,5,5,5,5,5,5,1,5,5,1,5,5,5,5,5,5,5,5,5,5,5,5,5,5,2,0,0,0
1,5,5,5,5,5,5,5,5,5,5,5,5,5,5,5,5,5,1,1,1,1,5,5,5,5,5,5,5,5,5,5,5,5,5,5,2,0,0,0
1,5,5,5,5,5,5,5,5,5,5,5,5,5,5,5,5,5,1,5,2,2,5,5,5,5,5,5,5,5,5,5,5,5,5,5,2,0,0,0
1,5,5,5,5,5,5,5,5,5,5,5,5,5,5,5,5,5,2,2,2,2,7,7,7,7,5,5,5,5,5,5,5,5,5,5,3,3,0,0
1,5,5,5,5,5,5,5,5,5,3,3,3,5,5,5,5,5,2,0,0,2,2,2,2,2,5,5,5,5,5,5,5,5,5,5,5,3,0,0
1,5,5,5,5,5,5,5,5,5,3,0,3,5,5,5,5,5,2,0,0,0,0,0,0,2,5,5,5,5,5,5,5,5,5,5,5,3,3,3
1,2,2,3,3,5,5,5,5,5,3,0,3,7,7,7,7,7,2,0,0,0,0,0,0,2,5,5,5,5,5,5,5,5,5,5,5,5,3,3
0,0,0,0,3,5,5,5,5,5,3,0,3,3,3,2,2,2,2,0,0,0,0,0,0,3,7,7,7,5,5,5,5,5,5,5,5,5,5,3
0,0,0,0,3,7,7,7,7,7,3,0,0,0,0,0,0,0,0,0,0,0,0,0,0,3,3,3,3,5,5,5,5,5,5,5,5,5,5,3
0,0,0,0,3,3,3,3,3,3,3,0,0,0,0,0,0,0,0,0,0,0,0,0,0,3,3,3,3,5,5,5,5,5,5,5,5,5,5,3
0,0,0,0,0,0,0,0,0,0,0,0,0,0,0,0,0,0,0,0,0,0,0,0,0,3,3,3,3,5,5,5,5,5,5,5,5,5,5,3
0,0,0,0,0,0,0,0,0,0,0,0,0,0,0,0,0,0,0,0,0,0,0,0,0,3,3,3,3,5,5,5,5,5,5,5,5,5,5,3
0,0,0,0,0,0,0,0,0,0,0,0,0,0,0,0,0,0,0,0,0,0,0,0,0,3,3,3,3,5,5,5,5,5,5,5,5,5,5,3
0,0,0,0,0,0,0,0,0,0,0,0,0,0,0,0,0,0,0,0,0,0,0,0,0,3,3,3,3,5,5,5,5,5,5,5,5,5,5,3
0,0,0,0,0,0,0,0,0,0,0,0,0,0,0,0,0,0,0,0,0,0,0,0,0,3,3,3,3,5,5,5,5,5,5,5,5,5,5,3
